11111111111111111111
10000000000000000001
10000000000000000001
10000010000010000001
10000000110011000001
10000000100001000001
11111111100111111101
10000000110001100001
10000000000000000011
10000000000001100011
11110011111111111111
10000000000000000001
10000100000000000001
10010100000100001001
11000011000011000001
11000010000010000001
11111111111111111101
10000011100011100001
10000000000000000011
11111111111111111111
