11111111111111111111
10000000000000000001
10000000000000000001
10000010000010000001
10000000110001000001
10000000100001000001
11111111100111111101
10000000110001100001
10000000000000100001
10000000000001100001
11110011111111111111
10000000000000000001
10000000000000000001
10000100000100001001
10000011000011000001
10000010000010000001
11111111111111111101
10000011100011100001
10000000000000000001
11111111111111111111
