100000000001
100000000001
100001000001
100000011001
100000010001
111111110011
100000111001
100000000011
100000000111
111111111111